111111111111111111111111111111111
111000000000000000000000011111111
11110111111111011100000010001
1111011111111101110101001N001
11111111 1111111 111111111111
